10
0 0 0 0 0 0 0 0 0 0
0 0 0 0 S 0 B 0 T 0
0 0 T T 0 S 0 B B 0
0 0 0 0 0 0 0 W W 0
T S 0 0 P 0 0 S S W
0 0 0 T S 0 0 0 T 0
0 S 0 0 W T B T S 0
0 0 0 0 0 T 0 S W W
B S 0 S 0 B 0 0 0 S
0 0 0 0 0 0 B 0 0 0